00000000000000000000000000000000000000000000000000000000000000000000000000000000
00000000000000000000000000000000000000000000000000000000000000000000000000000000
00000000000000000000000000000000000000000000000000000000000000000000000000000000
00000001111000000000000000111100000000000111100000000000000000001111000000000000
00000001111000000000000000111100000000000111100000000000000000001111000000000000
00000001111000000000000000111100000000000011110000000000000000011110000000000000
00000001111000000000000000111100000000000011110000000111100000011110000000000000
00000001111000000000000000111100000000000000111100001111110000111100000000000000
00000001111000000000000000111100000000000000111100001111110000111100000000000000
00000001111000000000000000111100000000000000011110011111111001111000000000000000
00000001111000000000000000111100000000000000011110011111111001111000000000000000
00000001111000000000000000111100000002000000001111111100111111110000000000000000
00000001111000000000000000111100000000000000001111111100111111110000000000000000
00000001111000000000000000111100000000000000000111111000011111100000000000000000
00000001111100000000000001111100000000000000000111111000011111100000000000000000
00000000111111111111111111111000000000000000000011110000001111000000000000000000
00000000000111111111111111000000000000000000000011110000001111000000000000000000
00000000000000000000000000000000000000000000000000000000000000000000000000000000
00000000000000000000000000000000000000000000000000000000000000000000000000000000
00000000000000000000000000000000000000000000000000000000000000000000000000000000
