00000000000000000000000000000000000000000000000000000000000000000000000000000000
00000000000000000000000000000000000000000000000000000000000000000000000000000000
00000000000000111111111111111111111111111111111111111000000000000000000000000000
00000000000000000000000000000000000000000000000000000000000000000000000000000000
00000000000000000000000000000000000000000000000000000000000000000000000000000000
00001111111111000000000000000000000000000111111110000000000000000000000000000000
00000000000000000000000000000000000000000000000010000000000000100000000000000000
00000000000000000001111111111111100000000000000010000000000000100000000000000000
00000000000000000000000000000000000000000000000010000000000000100000000000000000
00000000100000000000000000000000000000000000000010000000000000100000000000000000
00000000100000000000000000000000010000000000000010000000000000100000000000000000
00000000100000000000000000000000010000000000000010000000000000100000000000000000
00000000100000000000000000000000010000000000000010000000000000100000000000000000
00000000100000000000111111111111110000000000000010000000000000100000000000000000
00000000100000000000000000000000000000000000000000000000000000100000000000000000
00000000100000000000000000000000000000000000000000000000000000100000000000000000
00000000000000001000000000000020000000000000000000000000000000100000000000000000
00000000000000001000000000000000000000000000000000000000000000100000000000000000
00000000000000001000000000000000001111111111111111100000000000100000000000000000
00000000000000001111111100000000000000000000000000000000000000000000000000000000
00000000000000000000000000000000000000000000000000000000000000000000000000000000
