1111111111111100000000000000000000000000000000000000000000000000000100000000000
00000000000001000000000000000000000000000000000000000000000000000001000000000000
00000000000001000000011111111111111111100000000000000000001000000000000000000000
00000000000001000000010000000000000000000000000000000000001000000000000000000000
11110000111111000000010000000000000000000000000010000000001000000000000000000000
00000000000001000000010000000000000000000000000010000000001000001111111000000000
00000000000001000000010000000000000000000000000010000000001000000000001000000000
00000000000001000000000000000000000000000000000010000000001000000000001000000000
00001111000001000000000000000000000000000000000010000000001000000000001111100000
00000000000001111111111111100000111111111111111110000000001000000000000000000000
00000000000000000000000000000000000000000000000000000000001000000000000000000000
00000001111000000000000010000000001000000000200000000000001000000000000000000000
00000000001000000000000010000000001000000000000000000000001111111111100000000000
00000000001000000000000000000000000000000000000000000000000000000000000000000000
00100000001000111110000000111111111000000010000000100000001000000001000000010000
00111111111000100000001000000010000000100000001000000010000000010001000010000000
00100000001000000010000000100000001111111111111111100010001000000001111111110000
00000010000000100010001000000010000000100000001000000010000000010000000010000000
00100000001000000010000000100011111000000010000000111111111000000001000000010000
00000000000000000000000000000000000000000000000000000000000000000000000000000000
00000000000000000000000000000000000000000000000000000000000000000000000000000000
