00000000000000000000000000000000000000000000000000000000000000000000000000000000
00011100011111111111111111111111111111111111111111100011111111111111111111100000
00000100010000000000000000000000000000000000000000100000010000000000000000000000
00000100010000000000000000000000000000000000000000100000010000000000000000000000
00000100011111111111111111111111111111111111110000100000010000000000000000000000
00000100000000000000000000000000000000000000000000100000010000111111111111110000
00000100000000000000000000000000000000000000000000111000010000100000000000010000
00000100011111111111111111111111111111111111110000000000010000100000000000010000
00000100010000000000000000000000000000000000010000100000010000000000011111110000
00000100010000000000000000000000000000000000010000100000010000000000100000000000
00000100011111111111111111111111110000002000010000100000010000000000100000000000
00000100000000000000000000000000010000000000010000100000010000111111100000000000
00000100000000000000000000000000010000000000010000100000010000100000000000000000
00000100000000000000111111111111110000000000010000111000010000111111111111100000
00000100000000000000000000000000000000011111110000000000010000000000000000000000
00000100000000000000000000000000000000000000000000000000010000000000000000000000
00000100000000000001111111111111110000000000000000111111110000000000000000000000
00000100000000000000000000000000010000000000000000000000000000111111111111000000
00000100000000000000000000000000010000000000000000000000000000100000000000000000
00000111111111111111111111111111110001111111111111111111111111100000000000000000
00000000000000000000000000000000000000000000000000000000000000000000000000000000

